name = Test map

G 1 0 tiles/grass.png
W 0 1 tiles/water.png

WWWWWWWWWWWWWWWWWWWWWWWWWWWWWWWWWWWWWWWWWWWWWWWW
WWWWWWWWWWWWWWWWWWWWWWWWWWWWWWWWWWWWWWWWWWWWWWWW
WWWWWWWWWWWWWWWWWWWWWWWWWWWWWWWWWWWWWWWWWWWWWWWW
WWWWWWWWWWWWWWWWWWWWWWWWWWWWWWWWWWWWWWWWWWWWWWWW
WWWWWWWWWWWWWWWWWWWWWWWWWWWWWWWWWWWWWWWWWWWWWWWW
WWWWWWWWWWWWWWWWWWWWWWWWWWWWWWWWWWWWWWWWWWWWWWWW
WWWWWWWGGGWWWWWWWWWWWWWWWWWWGGGGWWWWWWWWWWWWWWWW
WWWWWWWGGGWWWWWWWWWWWGGGGGGGGGGGGGGWWWWWWWWWWWWW
WWWWWWWGGGGGGGGGGGGGGGGGGGGWWWWGGGGGGGWWWWWWWWWW
WWWWWWWWWGGGGWWWWGGGGGGGGGWWWWWGGGGGGWWWWWWWWWWW
WWWWWWWWWGGGGGGGGGGGGGGGGGGGGWGGGGGGGWWWWWWWWWWW
WWWWWWWGGGGGGGGGGGWWGGGGGGGGGGWWWGGGGWWWWWWWWWWW
WWWWWWWGGGWWWGGGGWWWWWWWWWGGGGGWGGGGGWWWWWWWWWWW
WWWWWWWGGGWWWGGGGWWWWWWWWWGGGGGGGGGGGWWWWWWWWWWW
WWWWWWWGGGWWWGGGGWWWWWWWWWGGGGGWGGGGGWWWWWWWWWWW
WWWWWWWGGGWWWGGGGWWWWWWWWWWGGGWGGGWWWWWWWWWWWWWW
WWWWWWWGGGWWGGGGGWWWWWGGGGGGGGGGGGGGWWWWWWWWWWWW
WWWWWWWGGGGGGGGGGWWWWWWWWWWWWWWWWGGWWWWWWWWWWWWW
WWWWWWWWWGGGGGGGGGGGGGGGGGGGGWWWGGGGGWWWWWWWWWWW
WWWWWWWWWGGGGGGGGGGGGGGGGGGGGWWWGGGGGWWWWWWWWWWW
WWWWWWWWWWGGGGGWWWWWWGGGGGGGGGGGGGGGGWWWWWWWWWWW
WWWWWWWWWWWGGGWWWWWWWGGGGGGGGGGGGGGGGWWWWWWWWWWW
WWWWWWWWWWWWWWWWWWWWWWGGGGGGGGGGGGWWWWWWWWWWWWWW
WWWWWWWWWWWWWWWWWWWWWWWWGGGGGGGGWWWWWWWWWWWWWWWW
WWWWWWWWWWWWWWWWWWWWWWWWWWWGGGGGGGGGWWWWWWWWWWWW
WWWWWWWWWGGGGGGGGGGGGGGGWWWWWWWGGGGGGGWWWWWWWWWW
WWWWWWWWWWWWWGGGGGGGGGGGGGGWWWWWGGGGGWWWWWWWWWWW
WWWWWWWWWWWWWWWWWGGGGGGGGGGGGGGGGGGGWWWWWWWWWWWW
WWWWWWWWWWWWWWWWWWWWWWWWWWWWWWWWWWWWWWWWWWWWWWWW
WWWWWWWWWWWWWWWWWWWWWWWWWWWWWWWWWWWWWWWWWWWWWWWW
WWWWWWWWWWWWWWWWWWWWWWWWWWWWWWWWWWWWWWWWWWWWWWWW
WWWWWWWWWWWWWWWWWWWWWWWWWWWWWWWWWWWWWWWWWWWWWWWW
WWWWWWWWWWWWWWWWWWWWWWWWWWWWWWWWWWWWWWWWWWWWWWWW
WWWWWWWWWWWWWWWWWWWWWWWWWWWWWWWWWWWWWWWWWWWWWWWW
