WWWWWWWWWWWWWWWWWWWWWWWWWWWWWWWWWWWW
WGGGWWWWWWWWWWWWWWWWWWGGGGWWWWWWWWWW
WGGGWWWWWWWWWWWGGGGGGGGGGGGGGWWWWWWW
WGGGGGGGGGGGGGGGGGGGGWWWWGGGGGGGWWWW
WWWGGGGWWWWGGGGGGGGGWWWWWGGGGGGWWWWW
WWWGGGGGGGGGGGGGGGGGGGGWGGGGGGGWWWWW
WGGGGGGGGGGGWWGGGGGGGGGGWWWGGGGWWWWW
WGGGWWWGGGGWWWWWWWWWGGGGGWGGGGGWWWWW
WGGGWWWGGGGWWWWWWWWWGGGGGGGGGGGWWWWW
WGGGWWWGGGGWWWWWWWWWGGGGGWGGGGGWWWWW
WGGGWWWGGGGWWWWWWWWWWGGGWGGGWWWWWWWW
WGGGWWGGGGGWWWWWGGGGGGGGGGGGGGWWWWWW
WGGGGGGGGGGWWWWWWWWWWWWWWWWGGWWWWWWW
WWWGGGGGGGGGGGGGGGGGGGGWWWGGGGGWWWWW
WWWGGGGGGGGGGGGGGGGGGGGWWWGGGGGWWWWW
WWWWGGGGGWWWWWWGGGGGGGGGGGGGGGGWWWWW
WWWWWGGGWWWWWWWGGGGGGGGGGGGGGGGWWWWW
WWWWWWWWWWWWWWWWGGGGGGGGGGGGWWWWWWWW
WWWWWWWWWWWWWWWWWWGGGGGGGGWWWWWWWWWW
WWWWWWWWWWWWWWWWWWWWWGGGGGGGGGWWWWWW
WWWGGGGGGGGGGGGGGGWWWWWWWGGGGGGGWWWW
WWWWWWWGGGGGGGGGGGGGGWWWWWGGGGGWWWWW
WWWWWWWWWWWGGGGGGGGGGGGGGGGGGGWWWWWW
WWWWWWWWWWWWWWWWWWWWWWWWWWWWWWWWWWWW

G 1 0 tiles/grass.png
W 0 1 tiles/water.png
